......####....####....####....####....####....####....####....####...............#.........................................4.................................
......####....####....####....####....####....####....####....####...............#.........................................4.................................
......####....####....####....####....####....####....####....####...............#.........................................4.................................
......####....####....####....####....####....####....####....####...............#............1...........1.....1..........4.................................
.............................................................1...................#.........................................4.................................
.................2......4..............4......2......1...............4...........|.........................................4...........1.....................
...........3.....................................................................|............2......................5.......................................
....................1........2................5.........3..................5.....|..........................................................................b
........................................2........................................|.....................1........3.................3..........................
.............1.....1.............1...................2......1....................|..............2..........................4.................................
.................................................................................#.........................................4.................................
..####....####....####....####....####....####....####....####....####...........#.............1...........................4.................................
..####....####....####....####....####....####....####....####....####...........#.....................1...................4.................................
..####....####....####....####....####....####....####....####....####...........#..............................1..........4.................................
..####....####....####....####....####....####....####....####....####...........#.........................................4.................................